1111111111111111
1000000000000001
1000000E00000001
1000000C00000001
1000000000000001
1000000CC0000001
1000000000000001
1000000P00000001
1111111111111111