111111111111111
1E0C000C0000C11
1000000000P0011
100001111100011
1000000C0000011
10 0C0000000C11
111111111111111