111111111111111111111111
1E000C010010001000011001
111001000010000000101011
101001100000101000100001
1P0000001000000000000101
111111111111111111111111