111111111111111111111111
1E0000010010001000011001
101001000010000000101011
101001100000101000100001
1P0000001C00C00000000101
111111111111111111111111