111111111111111
110000000000011
1100000000P0011
100C00000000011
11000E000000011
111111111111111
111111111111111