111111111111111
100P0000CC001E1
1000000000C01C1
111111111111111