11111111111111
11000000000001
1100000000P001
100C0000000001
11000E00000001
11111111111111