111111111111111111
1000000000000P0001
100C000E0000000001
111111111111111111