1111111
100PCE1
1111111
1111111
1111111
1111111
1111111