11111111111111
1E0C000C0000C1
1000000000P001
10000111110001
1000000C000001
10 0C0000000C1
11111111111111