11111111111111111
1E000010010000001
100100100C0001111
10011000010000001
10001001110000101
10100010000100101
10C100110C00100P1
11111111111111111